 0  0  0  1  1  1 12 17 18 18 18 18 18 18 18 19
 0  0  0  1  1  1 12 24 3  3  3  3  3  3  3  20
 1  1  1  1  1  1 12 23 22 22 22 22 22 22 22 21
 1  1  1  1  1  1 12 17 18 18 18 18 18 18 18 19
 1  1  1  1  1  1 12 24 3  3  3  3  3  3  3  20
 1  1  1  1  1  1 12 23 22 22 22 22 22 22 22 21
 1  1  1  1  1  1 11 10 10 10 10 10 10 10 10 10
 6  6  6  6  6  6  6  6  6  6  7  1  1  1  1  1
 2  2  2  2  2  2  2  2  2  2  8  1  1  1  1  1
10 10 10 10 10 10 10 10 10  2  8  1  1 25 26 27
17 18 18 18 18 18 19  2  2  2 16  1  1 32  4 28
24  3  3  3  3  3 20  2  2  2  2 16  1 31 30 29
23 22 22 22 22 22 21 13 10 14  2  2 16  1  1  1
17 18 18 18 18 18 19  8  1  1 14  2  2 16  1  1
24  3  3  3  3  3 20  8  1  1  1 14  2  2 16  1
23 22 22 22 22 22 21  8  1  1  1  1 14  2  2 16